###################
###################
##             ####
## ##### ##### ####
## 09#19 29#39 49##
## 08#18 28#38 48##
## 07#17 27#37 47##
## 06#16 26#36 46##
## 05#15 25#35 45##
## 04#14 24#34 44##
## 03#13 23#33 43#3
## 02#12 22#32 42##
## 01#11 21#31 41##
## 00#10 20#30 40##
## ########### ####
##      #      ####
#######E#X#########