########################
########################
#######07   19##########
#######06 # 18##########
#######05 # 17##########
#######04 # 16##########
#######03 # 15##########
#######02 # 14##########
#######01 # 13##########
#######00 # 12##########
######### # 11##########
E         # 10##########
########### 09##########
X           08##########
########################
########################
