########################
########################
########################
#######05   15##########
#######04 # 14##########
#######03 # 13##########
#######02 # 12##########
#######01 # 11##########
#######00 # 10##########
######### # 09##########
E         # 08##########
########### 07##########
X           06##########
########################
########################
########################