####################X##
#################### ##
E              ##### ##
## ##### ##### ##### ##
## 68#56 44#33 22### ##
## 67#55 43#32 21#10 ##
## 66#54 42#31 20#09 ##
## 65#53 41#30 19#08 ##
## 64#52 40#29 18#07 ##
## 63#51 39#28 17#06 ##
## 62#50 38#27 16#05 ##
## 61#49 37#26 15#04 ##
## 60#48 ##### 14#03 ##
## 59#47 36#25 13#02 ##
## 58#46 35#24 12#01 ##
## 57#45 34#23 11#00 ##
## ##### ##### ##### ##
##                   ##
#######################
#######################