########################
########################
X                     ##
######### ##### ##### ##
E   ##### ##### ##### ##
### 15#23 29#35 ##### ##
#07 14#22 28#34 41### ##
#06 13#21 27#33 40#46 ##
#05 12#20 ##### ##### ##
#04 11#19 ##### 39#45 ##
#03 10#18 26#32 38#44 ##
#02 09#17 25#31 37#43 ##
#01 08#16 24#30 36#42 ##
#00                   ##
########################
########################